###_________________#########
#___###################___#_#
#_####________________#_#_#_#
#_###################_#_#_#_#
#_____________________#_#_#_#
#####################_#_#_#_#
#___##________________#_#_#_#
#_#_##_###_##_#########_#_#_#
#_#____#___##B#_________#_#_#
#_#_##_################_#_#_#
###_##_____________####_#_#_#
###_##############_##_#_#_#_#
###_____________##____#_#_#_#
######_########_#######_#_#_#
######_####_____________#___#
A______######################
