_#___#__#B__
_#_#___####^
___#_#__#___
#_##_#_#_##_
###__#_#____
_#####_##_##
_###___##_##
A____#_____#
